"filename", "language", "C++", "C", "comment", "blank", "total"
"d:\Projects\Coding\_computer-graphics\space-invaders\src\glad\glad.c", "C", 0, 1769, 25, 47, 1841
"d:\Projects\Coding\_computer-graphics\space-invaders\src\moxxi\component.cpp", "C++", 17, 0, 0, 3, 20
"d:\Projects\Coding\_computer-graphics\space-invaders\src\moxxi\core.cpp", "C++", 68, 0, 10, 19, 97
"d:\Projects\Coding\_computer-graphics\space-invaders\src\moxxi\core.hpp", "C++", 272, 0, 34, 56, 362
"d:\Projects\Coding\_computer-graphics\space-invaders\src\moxxi\debug.cpp", "C++", 14, 0, 0, 4, 18
"d:\Projects\Coding\_computer-graphics\space-invaders\src\moxxi\gameobject.cpp", "C++", 24, 0, 0, 14, 38
"d:\Projects\Coding\_computer-graphics\space-invaders\src\moxxi\material.cpp", "C++", 4, 0, 0, 3, 7
"d:\Projects\Coding\_computer-graphics\space-invaders\src\moxxi\mesh.cpp", "C++", 67, 0, 0, 18, 85
"d:\Projects\Coding\_computer-graphics\space-invaders\src\moxxi\object.cpp", "C++", 13, 0, 0, 6, 19
"d:\Projects\Coding\_computer-graphics\space-invaders\src\moxxi\physics2d.cpp", "C++", 0, 0, 0, 1, 1
"d:\Projects\Coding\_computer-graphics\space-invaders\src\moxxi\resource_manager.cpp", "C++", 133, 0, 23, 21, 177
"d:\Projects\Coding\_computer-graphics\space-invaders\src\moxxi\scene.cpp", "C++", 53, 0, 0, 13, 66
"d:\Projects\Coding\_computer-graphics\space-invaders\src\moxxi\scene_manager.cpp", "C++", 19, 0, 0, 8, 27
"d:\Projects\Coding\_computer-graphics\space-invaders\src\moxxi\shader.cpp", "C++", 121, 0, 13, 8, 142
"d:\Projects\Coding\_computer-graphics\space-invaders\src\moxxi\texture.cpp", "C++", 26, 0, 11, 6, 43
"d:\Projects\Coding\_computer-graphics\space-invaders\src\moxxi\transform.cpp", "C++", 22, 0, 0, 8, 30
"d:\Projects\Coding\_computer-graphics\space-invaders\src\space-invaders\main.cpp", "C++", 18, 0, 4, 9, 31
"d:\Projects\Coding\_computer-graphics\space-invaders\src\space-invaders\player.cpp", "C++", 1, 0, 0, 1, 2
"d:\Projects\Coding\_computer-graphics\space-invaders\src\stbi\stb_image.cpp", "C++", 2, 0, 0, 0, 2
"Total", "-", 874, 1769, 120, 245, 3008